Isabella Miller - ISABELLA.MILLER@EXAMPLE.COM
Lucas Johnson - LUCAS.JOHNSON@EXAMPLE.COM
Ava Smith - AVA.SMITH@EXAMPLE.COM
Isabella Jones - ISABELLA.JONES@EXAMPLE.COM
Emma Brown - EMMA.BROWN@EXAMPLE.COM
Elijah Brown - ELIJAH.BROWN@EXAMPLE.COM
Sophia Jones - SOPHIA.JONES@EXAMPLE.COM
Olivia Brown - OLIVIA.BROWN@EXAMPLE.COM
Sophia Rodriguez - SOPHIA.RODRIGUEZ@EXAMPLE.COM
Ava Jones - AVA.JONES@EXAMPLE.COM
Ava Davis - AVA.DAVIS@EXAMPLE.COM
Noah Brown - NOAH.BROWN@EXAMPLE.COM
Noah Martinez - NOAH.MARTINEZ@EXAMPLE.COM
Noah Smith - NOAH.SMITH@EXAMPLE.COM
Sophia Williams - SOPHIA.WILLIAMS@EXAMPLE.COM
Elijah Williams - ELIJAH.WILLIAMS@EXAMPLE.COM
Olivia Jones - OLIVIA.JONES@EXAMPLE.COM
Isabella Smith - ISABELLA.SMITH@EXAMPLE.COM
Oliver Williams - OLIVER.WILLIAMS@EXAMPLE.COM
Sophia Brown - SOPHIA.BROWN@EXAMPLE.COM
Sophia Davis - SOPHIA.DAVIS@EXAMPLE.COM
Noah Johnson - NOAH.JOHNSON@EXAMPLE.COM
Ava Miller - AVA.MILLER@EXAMPLE.COM
Liam Davis - LIAM.DAVIS@EXAMPLE.COM
Emma Jones - EMMA.JONES@EXAMPLE.COM
Isabella Garcia - ISABELLA.GARCIA@EXAMPLE.COM
Liam Jones - LIAM.JONES@EXAMPLE.COM
Liam Brown - LIAM.BROWN@EXAMPLE.COM
Ava Garcia - AVA.GARCIA@EXAMPLE.COM
Sophia Martinez - SOPHIA.MARTINEZ@EXAMPLE.COM
Liam Martinez - LIAM.MARTINEZ@EXAMPLE.COM
Olivia Williams - OLIVIA.WILLIAMS@EXAMPLE.COM
Liam Miller - LIAM.MILLER@EXAMPLE.COM
Olivia Rodriguez - OLIVIA.RODRIGUEZ@EXAMPLE.COM
Elijah Davis - ELIJAH.DAVIS@EXAMPLE.COM
Isabella Martinez - ISABELLA.MARTINEZ@EXAMPLE.COM
Oliver Miller - OLIVER.MILLER@EXAMPLE.COM
Olivia Miller - OLIVIA.MILLER@EXAMPLE.COM
Ava Williams - AVA.WILLIAMS@EXAMPLE.COM
Sophia Johnson - SOPHIA.JOHNSON@EXAMPLE.COM
Olivia Davis - OLIVIA.DAVIS@EXAMPLE.COM
Lucas Miller - LUCAS.MILLER@EXAMPLE.COM
Lucas Brown - LUCAS.BROWN@EXAMPLE.COM
Oliver Garcia - OLIVER.GARCIA@EXAMPLE.COM
Oliver Davis - OLIVER.DAVIS@EXAMPLE.COM
Olivia Johnson - OLIVIA.JOHNSON@EXAMPLE.COM
Liam Smith - LIAM.SMITH@EXAMPLE.COM
Isabella Davis - ISABELLA.DAVIS@EXAMPLE.COM
Ava Johnson - AVA.JOHNSON@EXAMPLE.COM
Lucas Jones - LUCAS.JONES@EXAMPLE.COM
Isabella Williams - ISABELLA.WILLIAMS@EXAMPLE.COM
Ava Brown - AVA.BROWN@EXAMPLE.COM
Elijah Garcia - ELIJAH.GARCIA@EXAMPLE.COM
Liam Johnson - LIAM.JOHNSON@EXAMPLE.COM
Noah Williams - NOAH.WILLIAMS@EXAMPLE.COM
Emma Johnson - EMMA.JOHNSON@EXAMPLE.COM
Liam Rodriguez - LIAM.RODRIGUEZ@EXAMPLE.COM
Noah Davis - NOAH.DAVIS@EXAMPLE.COM
Emma Smith - EMMA.SMITH@EXAMPLE.COM
Ava Martinez - AVA.MARTINEZ@EXAMPLE.COM
Isabella Johnson - ISABELLA.JOHNSON@EXAMPLE.COM
Emma Martinez - EMMA.MARTINEZ@EXAMPLE.COM
Elijah Miller - ELIJAH.MILLER@EXAMPLE.COM
Emma Williams - EMMA.WILLIAMS@EXAMPLE.COM
Noah Garcia - NOAH.GARCIA@EXAMPLE.COM
Lucas Smith - LUCAS.SMITH@EXAMPLE.COM
Emma Miller - EMMA.MILLER@EXAMPLE.COM
Sophia Garcia - SOPHIA.GARCIA@EXAMPLE.COM
Lucas Garcia - LUCAS.GARCIA@EXAMPLE.COM
Emma Davis - EMMA.DAVIS@EXAMPLE.COM
Oliver Martinez - OLIVER.MARTINEZ@EXAMPLE.COM
Lucas Williams - LUCAS.WILLIAMS@EXAMPLE.COM
Elijah Martinez - ELIJAH.MARTINEZ@EXAMPLE.COM
Oliver Smith - OLIVER.SMITH@EXAMPLE.COM
Emma Garcia - EMMA.GARCIA@EXAMPLE.COM
Liam Garcia - LIAM.GARCIA@EXAMPLE.COM
Elijah Johnson - ELIJAH.JOHNSON@EXAMPLE.COM
Isabella Brown - ISABELLA.BROWN@EXAMPLE.COM
Emma Rodriguez - EMMA.RODRIGUEZ@EXAMPLE.COM
Lucas Davis - LUCAS.DAVIS@EXAMPLE.COM
Elijah Smith - ELIJAH.SMITH@EXAMPLE.COM
Oliver Johnson - OLIVER.JOHNSON@EXAMPLE.COM
Olivia Smith - OLIVIA.SMITH@EXAMPLE.COM
Lucas Martinez - LUCAS.MARTINEZ@EXAMPLE.COM
Ava Rodriguez - AVA.RODRIGUEZ@EXAMPLE.COM
Olivia Martinez - OLIVIA.MARTINEZ@EXAMPLE.COM
Oliver Brown - OLIVER.BROWN@EXAMPLE.COM
Liam Williams - LIAM.WILLIAMS@EXAMPLE.COM
Noah Rodriguez - NOAH.RODRIGUEZ@EXAMPLE.COM
Noah Miller - NOAH.MILLER@EXAMPLE.COM
Sophia Miller - SOPHIA.MILLER@EXAMPLE.COM
Sophia Smith - SOPHIA.SMITH@EXAMPLE.COM
Oliver Jones - OLIVER.JONES@EXAMPLE.COM
Lucas Rodriguez - LUCAS.RODRIGUEZ@EXAMPLE.COM
Noah Jones - NOAH.JONES@EXAMPLE.COM
Elijah Jones - ELIJAH.JONES@EXAMPLE.COM
Oliver Rodriguez - OLIVER.RODRIGUEZ@EXAMPLE.COM
Isabella Rodriguez - ISABELLA.RODRIGUEZ@EXAMPLE.COM
Olivia Garcia - OLIVIA.GARCIA@EXAMPLE.COM
Elijah Rodriguez - ELIJAH.RODRIGUEZ@EXAMPLE.COM
